7 20 6 12 0 18
WWWWWWWWWWWWWWWWWWWWWW
WWWWWWWWWWWWWWWWWWW.WW
WW.....W........WWW.WW
WW.WWWWW..WWWWW..WW.WW
WW.WWWWW.WWWWWWW.WW.WW
WW.W..........WW.WW.WW
WW.WWWWWWWWWW.WW....WW
WWWWWWWWWWWWW.WWWWWWWW
WWWWWWWWWWWWWWWWWWWWWW