4 5 2 0 1 4
WWWWWWW
W.W..WW
W.WW..W
W.W.WWW
W.....W
WWWWWWW