10 10 4 0 5 9 
WWWWWWWWWWWW
W..W..WWWWWW
W..W......WW
WWWWW..W...W
W...W..WWW.W
W...WW...W.W
W.WWW....W.W
W..W..W..W.W
W..WWWW.WWWW
W.....W.W..W
W.......W..W
WWWWWWWWWWWW











