10 12 8 2 4 11
WWWWWWWWWWWWWW
WWWWWWWWWWWWWW
WW...WW.W.W.WW
WWWW.W......WW
WWW....WWWW.WW
WWW.WWWWWWW..W
WWW.W.WWWWWWWW
WWW...WWWWWWWW
WWWWW.WWW.W.WW
WWW.....W...WW
WWWWWWWWWWWWWW
WWWWWWWWWWWWWW